..........##
##########
#........#####
#..@.........#
####.#####...#
#.....$#..$$$#
####......####
#.....%...$$##
##.......$$#
############