..........###
##########
#........#####
#..@.........#
####.#####...#
#.....$...$$$#
####......####
#.....%...$$##
##.......$$#
############