..........
##########
#........#####
#..@.........#
####.#####...#
#....#$...$$$#
####......####
#.....%...$$##
##.......$$#
############